1111111111111111111111
10P0C01000000000100001
111111100000000000E001
1000000000000000111111
1000010000000000000001
1000010000000000000001
1000000000000000000001
1111111111111111111111
