1111111111111111111111
10P0001000000000100001
100000100000000000E001
100000000C000000111111
1000010000000000000001
1000010000000000000001
100C0000C0000000000001
1111111111111111111111
